"filename", "language", "Java", "comment", "blank", "total"
"d:\魔兽\Warcraft III Frozen Throne\Maps\羊皮纸\中世纪UI\Backend\Mythostrike\src\Core\Card.java", "Java", 38, 0, 10, 48
"d:\魔兽\Warcraft III Frozen Throne\Maps\羊皮纸\中世纪UI\Backend\Mythostrike\src\Core\CardData.java", "Java", 31, 0, 9, 40
"d:\魔兽\Warcraft III Frozen Throne\Maps\羊皮纸\中世纪UI\Backend\Mythostrike\src\Core\CardDeck.java", "Java", 7, 0, 5, 12
"d:\魔兽\Warcraft III Frozen Throne\Maps\羊皮纸\中世纪UI\Backend\Mythostrike\src\Core\CardList.java", "Java", 28, 0, 5, 33
"d:\魔兽\Warcraft III Frozen Throne\Maps\羊皮纸\中世纪UI\Backend\Mythostrike\src\Core\CardSpace.java", "Java", 24, 0, 5, 29
"d:\魔兽\Warcraft III Frozen Throne\Maps\羊皮纸\中世纪UI\Backend\Mythostrike\src\Core\CardSymbol.java", "Java", 4, 0, 2, 6
"d:\魔兽\Warcraft III Frozen Throne\Maps\羊皮纸\中世纪UI\Backend\Mythostrike\src\Core\CardType.java", "Java", 4, 0, 2, 6
"d:\魔兽\Warcraft III Frozen Throne\Maps\羊皮纸\中世纪UI\Backend\Mythostrike\src\Core\Champion.java", "Java", 33, 0, 11, 44
"d:\魔兽\Warcraft III Frozen Throne\Maps\羊皮纸\中世纪UI\Backend\Mythostrike\src\Core\ChampionData.java", "Java", 40, 0, 14, 54
"d:\魔兽\Warcraft III Frozen Throne\Maps\羊皮纸\中世纪UI\Backend\Mythostrike\src\Core\Game.java", "Java", 60, 6, 19, 85
"d:\魔兽\Warcraft III Frozen Throne\Maps\羊皮纸\中世纪UI\Backend\Mythostrike\src\Core\GameController.java", "Java", 226, 47, 45, 318
"d:\魔兽\Warcraft III Frozen Throne\Maps\羊皮纸\中世纪UI\Backend\Mythostrike\src\Core\Identity.java", "Java", 4, 0, 2, 6
"d:\魔兽\Warcraft III Frozen Throne\Maps\羊皮纸\中世纪UI\Backend\Mythostrike\src\Core\Mode.java", "Java", 15, 0, 7, 22
"d:\魔兽\Warcraft III Frozen Throne\Maps\羊皮纸\中世纪UI\Backend\Mythostrike\src\Core\Phase.java", "Java", 10, 0, 2, 12
"d:\魔兽\Warcraft III Frozen Throne\Maps\羊皮纸\中世纪UI\Backend\Mythostrike\src\Core\Player.java", "Java", 124, 0, 30, 154
"d:\魔兽\Warcraft III Frozen Throne\Maps\羊皮纸\中世纪UI\Backend\Mythostrike\src\Core\Skill.java", "Java", 48, 0, 17, 65
"d:\魔兽\Warcraft III Frozen Throne\Maps\羊皮纸\中世纪UI\Backend\Mythostrike\src\Core\Skill_Trigger.java", "Java", 23, 0, 9, 32
"d:\魔兽\Warcraft III Frozen Throne\Maps\羊皮纸\中世纪UI\Backend\Mythostrike\src\Core\TriggerSkillData.java", "Java", 53, 1, 12, 66
"d:\魔兽\Warcraft III Frozen Throne\Maps\羊皮纸\中世纪UI\Backend\Mythostrike\src\Events\Event.java", "Java", 15, 6, 6, 27
"d:\魔兽\Warcraft III Frozen Throne\Maps\羊皮纸\中世纪UI\Backend\Mythostrike\src\Events\EventType.java", "Java", 83, 0, 27, 110
"d:\魔兽\Warcraft III Frozen Throne\Maps\羊皮纸\中世纪UI\Backend\Mythostrike\src\Events\Handle\CardDrawHandle.java", "Java", 33, 0, 11, 44
"d:\魔兽\Warcraft III Frozen Throne\Maps\羊皮纸\中世纪UI\Backend\Mythostrike\src\Events\Handle\CardMoveHandle.java", "Java", 68, 0, 18, 86
"d:\魔兽\Warcraft III Frozen Throne\Maps\羊皮纸\中世纪UI\Backend\Mythostrike\src\Events\Handle\DamageHandle.java", "Java", 63, 0, 18, 81
"d:\魔兽\Warcraft III Frozen Throne\Maps\羊皮纸\中世纪UI\Backend\Mythostrike\src\Events\Handle\DamageType.java", "Java", 11, 0, 5, 16
"d:\魔兽\Warcraft III Frozen Throne\Maps\羊皮纸\中世纪UI\Backend\Mythostrike\src\Events\Handle\EventHandle.java", "Java", 11, 0, 10, 21
"d:\魔兽\Warcraft III Frozen Throne\Maps\羊皮纸\中世纪UI\Backend\Mythostrike\src\Events\Listener\EventCardDrawListener.java", "Java", 3, 0, 2, 5
"d:\魔兽\Warcraft III Frozen Throne\Maps\羊皮纸\中世纪UI\Backend\Mythostrike\src\Events\Listener\EventDamageListener.java", "Java", 23, 0, 12, 35
"d:\魔兽\Warcraft III Frozen Throne\Maps\羊皮纸\中世纪UI\Backend\Mythostrike\src\Events\Listener\EventPhaseListener.java", "Java", 14, 0, 6, 20
"d:\魔兽\Warcraft III Frozen Throne\Maps\羊皮纸\中世纪UI\Backend\Mythostrike\src\Events\Listener\FunctionListener.java", "Java", 9, 0, 7, 16
"d:\魔兽\Warcraft III Frozen Throne\Maps\羊皮纸\中世纪UI\Backend\Mythostrike\src\Events\PhaseChangeHandle.java", "Java", 16, 0, 4, 20
"d:\魔兽\Warcraft III Frozen Throne\Maps\羊皮纸\中世纪UI\Backend\Mythostrike\src\Test\InputConditions.java", "Java", 46, 6, 17, 69
"d:\魔兽\Warcraft III Frozen Throne\Maps\羊皮纸\中世纪UI\Backend\Mythostrike\src\Test\Main.java", "Java", 130, 9, 21, 160
"Total", "-", 1297, 75, 370, 1742