"filename", "language", "Java", "comment", "blank", "total"
"d:\魔兽\Warcraft III Frozen Throne\Maps\羊皮纸\中世纪UI\Backend\Mythostrike\src\Core\Card.java", "Java", 38, 0, 10, 48
"d:\魔兽\Warcraft III Frozen Throne\Maps\羊皮纸\中世纪UI\Backend\Mythostrike\src\Core\CardData.java", "Java", 31, 0, 9, 40
"d:\魔兽\Warcraft III Frozen Throne\Maps\羊皮纸\中世纪UI\Backend\Mythostrike\src\Core\CardDeck.java", "Java", 28, 0, 5, 33
"d:\魔兽\Warcraft III Frozen Throne\Maps\羊皮纸\中世纪UI\Backend\Mythostrike\src\Core\CardSpace.java", "Java", 25, 0, 5, 30
"d:\魔兽\Warcraft III Frozen Throne\Maps\羊皮纸\中世纪UI\Backend\Mythostrike\src\Core\CardSymbol.java", "Java", 4, 0, 2, 6
"d:\魔兽\Warcraft III Frozen Throne\Maps\羊皮纸\中世纪UI\Backend\Mythostrike\src\Core\CardType.java", "Java", 4, 0, 2, 6
"d:\魔兽\Warcraft III Frozen Throne\Maps\羊皮纸\中世纪UI\Backend\Mythostrike\src\Core\Champion.java", "Java", 33, 0, 11, 44
"d:\魔兽\Warcraft III Frozen Throne\Maps\羊皮纸\中世纪UI\Backend\Mythostrike\src\Core\ChampionData.java", "Java", 39, 0, 14, 53
"d:\魔兽\Warcraft III Frozen Throne\Maps\羊皮纸\中世纪UI\Backend\Mythostrike\src\Core\Game.java", "Java", 60, 6, 18, 84
"d:\魔兽\Warcraft III Frozen Throne\Maps\羊皮纸\中世纪UI\Backend\Mythostrike\src\Core\GameController.java", "Java", 126, 14, 20, 160
"d:\魔兽\Warcraft III Frozen Throne\Maps\羊皮纸\中世纪UI\Backend\Mythostrike\src\Core\Identity.java", "Java", 4, 0, 2, 6
"d:\魔兽\Warcraft III Frozen Throne\Maps\羊皮纸\中世纪UI\Backend\Mythostrike\src\Core\Mode.java", "Java", 15, 0, 7, 22
"d:\魔兽\Warcraft III Frozen Throne\Maps\羊皮纸\中世纪UI\Backend\Mythostrike\src\Core\Phase.java", "Java", 4, 0, 2, 6
"d:\魔兽\Warcraft III Frozen Throne\Maps\羊皮纸\中世纪UI\Backend\Mythostrike\src\Core\Player.java", "Java", 116, 0, 30, 146
"d:\魔兽\Warcraft III Frozen Throne\Maps\羊皮纸\中世纪UI\Backend\Mythostrike\src\Core\Skill.java", "Java", 48, 0, 17, 65
"d:\魔兽\Warcraft III Frozen Throne\Maps\羊皮纸\中世纪UI\Backend\Mythostrike\src\Core\Skill_Trigger.java", "Java", 23, 0, 9, 32
"d:\魔兽\Warcraft III Frozen Throne\Maps\羊皮纸\中世纪UI\Backend\Mythostrike\src\Core\TriggerSkillData.java", "Java", 61, 0, 12, 73
"Total", "-", 659, 20, 175, 854