"filename", "language", "Java", "comment", "blank", "total"
"d:\魔兽\Warcraft III Frozen Throne\Maps\羊皮纸\中世纪UI\Backend\Mythostrike\src\core\Card.java", "Java", 38, 0, 10, 48
"d:\魔兽\Warcraft III Frozen Throne\Maps\羊皮纸\中世纪UI\Backend\Mythostrike\src\core\CardData.java", "Java", 31, 0, 9, 40
"d:\魔兽\Warcraft III Frozen Throne\Maps\羊皮纸\中世纪UI\Backend\Mythostrike\src\core\CardDeck.java", "Java", 7, 0, 5, 12
"d:\魔兽\Warcraft III Frozen Throne\Maps\羊皮纸\中世纪UI\Backend\Mythostrike\src\core\CardList.java", "Java", 24, 0, 4, 28
"d:\魔兽\Warcraft III Frozen Throne\Maps\羊皮纸\中世纪UI\Backend\Mythostrike\src\core\CardSpace.java", "Java", 24, 0, 5, 29
"d:\魔兽\Warcraft III Frozen Throne\Maps\羊皮纸\中世纪UI\Backend\Mythostrike\src\core\CardSymbol.java", "Java", 4, 0, 2, 6
"d:\魔兽\Warcraft III Frozen Throne\Maps\羊皮纸\中世纪UI\Backend\Mythostrike\src\core\CardType.java", "Java", 4, 0, 2, 6
"d:\魔兽\Warcraft III Frozen Throne\Maps\羊皮纸\中世纪UI\Backend\Mythostrike\src\core\Champion.java", "Java", 33, 0, 11, 44
"d:\魔兽\Warcraft III Frozen Throne\Maps\羊皮纸\中世纪UI\Backend\Mythostrike\src\core\ChampionData.java", "Java", 40, 0, 14, 54
"d:\魔兽\Warcraft III Frozen Throne\Maps\羊皮纸\中世纪UI\Backend\Mythostrike\src\core\Game.java", "Java", 60, 6, 19, 85
"d:\魔兽\Warcraft III Frozen Throne\Maps\羊皮纸\中世纪UI\Backend\Mythostrike\src\core\GameController.java", "Java", 198, 39, 42, 279
"d:\魔兽\Warcraft III Frozen Throne\Maps\羊皮纸\中世纪UI\Backend\Mythostrike\src\core\Identity.java", "Java", 4, 0, 2, 6
"d:\魔兽\Warcraft III Frozen Throne\Maps\羊皮纸\中世纪UI\Backend\Mythostrike\src\core\Mode.java", "Java", 15, 0, 7, 22
"d:\魔兽\Warcraft III Frozen Throne\Maps\羊皮纸\中世纪UI\Backend\Mythostrike\src\core\Phase.java", "Java", 10, 0, 2, 12
"d:\魔兽\Warcraft III Frozen Throne\Maps\羊皮纸\中世纪UI\Backend\Mythostrike\src\core\Player.java", "Java", 122, 0, 30, 152
"d:\魔兽\Warcraft III Frozen Throne\Maps\羊皮纸\中世纪UI\Backend\Mythostrike\src\core\Skill.java", "Java", 48, 0, 17, 65
"d:\魔兽\Warcraft III Frozen Throne\Maps\羊皮纸\中世纪UI\Backend\Mythostrike\src\core\Skill_Trigger.java", "Java", 23, 0, 9, 32
"d:\魔兽\Warcraft III Frozen Throne\Maps\羊皮纸\中世纪UI\Backend\Mythostrike\src\core\TriggerSkillData.java", "Java", 53, 1, 12, 66
"d:\魔兽\Warcraft III Frozen Throne\Maps\羊皮纸\中世纪UI\Backend\Mythostrike\src\events\Event.java", "Java", 15, 6, 6, 27
"d:\魔兽\Warcraft III Frozen Throne\Maps\羊皮纸\中世纪UI\Backend\Mythostrike\src\events\EventType.java", "Java", 83, 0, 27, 110
"d:\魔兽\Warcraft III Frozen Throne\Maps\羊皮纸\中世纪UI\Backend\Mythostrike\src\events\Handle\CardDrawHandle.java", "Java", 24, 0, 8, 32
"d:\魔兽\Warcraft III Frozen Throne\Maps\羊皮纸\中世纪UI\Backend\Mythostrike\src\events\Handle\DamageHandle.java", "Java", 63, 0, 18, 81
"d:\魔兽\Warcraft III Frozen Throne\Maps\羊皮纸\中世纪UI\Backend\Mythostrike\src\events\Handle\DamageType.java", "Java", 11, 0, 5, 16
"d:\魔兽\Warcraft III Frozen Throne\Maps\羊皮纸\中世纪UI\Backend\Mythostrike\src\events\Handle\EventHandle.java", "Java", 11, 0, 10, 21
"d:\魔兽\Warcraft III Frozen Throne\Maps\羊皮纸\中世纪UI\Backend\Mythostrike\src\events\Listener\EventCardDrawListener.java", "Java", 3, 0, 2, 5
"d:\魔兽\Warcraft III Frozen Throne\Maps\羊皮纸\中世纪UI\Backend\Mythostrike\src\events\Listener\EventDamageListener.java", "Java", 23, 0, 12, 35
"d:\魔兽\Warcraft III Frozen Throne\Maps\羊皮纸\中世纪UI\Backend\Mythostrike\src\events\Listener\EventPhaseListener.java", "Java", 14, 0, 6, 20
"d:\魔兽\Warcraft III Frozen Throne\Maps\羊皮纸\中世纪UI\Backend\Mythostrike\src\events\Listener\FunctionListener.java", "Java", 9, 0, 7, 16
"d:\魔兽\Warcraft III Frozen Throne\Maps\羊皮纸\中世纪UI\Backend\Mythostrike\src\events\PhaseChangeHandle.java", "Java", 16, 0, 4, 20
"d:\魔兽\Warcraft III Frozen Throne\Maps\羊皮纸\中世纪UI\Backend\Mythostrike\src\Test\InputConditions.java", "Java", 46, 6, 17, 69
"d:\魔兽\Warcraft III Frozen Throne\Maps\羊皮纸\中世纪UI\Backend\Mythostrike\src\Test\Main.java", "Java", 124, 9, 20, 153
"Total", "-", 1180, 67, 344, 1591