"filename", "language", "Java", "comment", "blank", "total"
"d:\魔兽\Warcraft III Frozen Throne\Maps\羊皮纸\中世纪UI\Backend\Mythostrike\src\Core\Card.java", "Java", 38, 0, 10, 48
"d:\魔兽\Warcraft III Frozen Throne\Maps\羊皮纸\中世纪UI\Backend\Mythostrike\src\Core\CardData.java", "Java", 31, 0, 9, 40
"d:\魔兽\Warcraft III Frozen Throne\Maps\羊皮纸\中世纪UI\Backend\Mythostrike\src\Core\CardDeck.java", "Java", 14, 0, 5, 19
"d:\魔兽\Warcraft III Frozen Throne\Maps\羊皮纸\中世纪UI\Backend\Mythostrike\src\Core\CardList.java", "Java", 28, 0, 5, 33
"d:\魔兽\Warcraft III Frozen Throne\Maps\羊皮纸\中世纪UI\Backend\Mythostrike\src\Core\CardSpace.java", "Java", 24, 0, 5, 29
"d:\魔兽\Warcraft III Frozen Throne\Maps\羊皮纸\中世纪UI\Backend\Mythostrike\src\Core\CardSymbol.java", "Java", 4, 0, 2, 6
"d:\魔兽\Warcraft III Frozen Throne\Maps\羊皮纸\中世纪UI\Backend\Mythostrike\src\Core\CardType.java", "Java", 4, 0, 2, 6
"d:\魔兽\Warcraft III Frozen Throne\Maps\羊皮纸\中世纪UI\Backend\Mythostrike\src\Core\Champion.java", "Java", 33, 0, 11, 44
"d:\魔兽\Warcraft III Frozen Throne\Maps\羊皮纸\中世纪UI\Backend\Mythostrike\src\Core\ChampionData.java", "Java", 40, 0, 14, 54
"d:\魔兽\Warcraft III Frozen Throne\Maps\羊皮纸\中世纪UI\Backend\Mythostrike\src\Core\Game.java", "Java", 60, 6, 19, 85
"d:\魔兽\Warcraft III Frozen Throne\Maps\羊皮纸\中世纪UI\Backend\Mythostrike\src\Core\GameController.java", "Java", 205, 42, 48, 295
"d:\魔兽\Warcraft III Frozen Throne\Maps\羊皮纸\中世纪UI\Backend\Mythostrike\src\Core\Identity.java", "Java", 4, 0, 2, 6
"d:\魔兽\Warcraft III Frozen Throne\Maps\羊皮纸\中世纪UI\Backend\Mythostrike\src\Core\Mode.java", "Java", 15, 0, 7, 22
"d:\魔兽\Warcraft III Frozen Throne\Maps\羊皮纸\中世纪UI\Backend\Mythostrike\src\Core\Phase.java", "Java", 10, 0, 3, 13
"d:\魔兽\Warcraft III Frozen Throne\Maps\羊皮纸\中世纪UI\Backend\Mythostrike\src\Core\Player.java", "Java", 124, 0, 30, 154
"d:\魔兽\Warcraft III Frozen Throne\Maps\羊皮纸\中世纪UI\Backend\Mythostrike\src\Core\Skill.java", "Java", 40, 0, 18, 58
"d:\魔兽\Warcraft III Frozen Throne\Maps\羊皮纸\中世纪UI\Backend\Mythostrike\src\Core\Skill_Trigger.java", "Java", 18, 0, 7, 25
"d:\魔兽\Warcraft III Frozen Throne\Maps\羊皮纸\中世纪UI\Backend\Mythostrike\src\Core\TriggerSkillData.java", "Java", 56, 1, 12, 69
"d:\魔兽\Warcraft III Frozen Throne\Maps\羊皮纸\中世纪UI\Backend\Mythostrike\src\Events\EventType.java", "Java", 72, 15, 23, 110
"d:\魔兽\Warcraft III Frozen Throne\Maps\羊皮纸\中世纪UI\Backend\Mythostrike\src\Events\Handle\CardDrawHandle.java", "Java", 26, 0, 9, 35
"d:\魔兽\Warcraft III Frozen Throne\Maps\羊皮纸\中世纪UI\Backend\Mythostrike\src\Events\Handle\CardMoveHandle.java", "Java", 40, 0, 11, 51
"d:\魔兽\Warcraft III Frozen Throne\Maps\羊皮纸\中世纪UI\Backend\Mythostrike\src\Events\Handle\DamageHandle.java", "Java", 48, 0, 15, 63
"d:\魔兽\Warcraft III Frozen Throne\Maps\羊皮纸\中世纪UI\Backend\Mythostrike\src\Events\Handle\DamageType.java", "Java", 11, 0, 5, 16
"d:\魔兽\Warcraft III Frozen Throne\Maps\羊皮纸\中世纪UI\Backend\Mythostrike\src\Events\Handle\EventHandle.java", "Java", 40, 0, 17, 57
"d:\魔兽\Warcraft III Frozen Throne\Maps\羊皮纸\中世纪UI\Backend\Mythostrike\src\Events\Handle\PhaseHandle.java", "Java", 18, 0, 6, 24
"d:\魔兽\Warcraft III Frozen Throne\Maps\羊皮纸\中世纪UI\Backend\Mythostrike\src\Events\Listener\EventCardDrawListener.java", "Java", 3, 0, 2, 5
"d:\魔兽\Warcraft III Frozen Throne\Maps\羊皮纸\中世纪UI\Backend\Mythostrike\src\Events\Listener\EventDamageListener.java", "Java", 23, 0, 13, 36
"d:\魔兽\Warcraft III Frozen Throne\Maps\羊皮纸\中世纪UI\Backend\Mythostrike\src\Events\Listener\EventPhaseListener.java", "Java", 19, 0, 8, 27
"d:\魔兽\Warcraft III Frozen Throne\Maps\羊皮纸\中世纪UI\Backend\Mythostrike\src\Events\Listener\FunctionListener.java", "Java", 16, 0, 9, 25
"d:\魔兽\Warcraft III Frozen Throne\Maps\羊皮纸\中世纪UI\Backend\Mythostrike\src\Events\PhaseChangeHandle.java", "Java", 15, 0, 4, 19
"d:\魔兽\Warcraft III Frozen Throne\Maps\羊皮纸\中世纪UI\Backend\Mythostrike\src\Test\InputConditions.java", "Java", 46, 6, 17, 69
"d:\魔兽\Warcraft III Frozen Throne\Maps\羊皮纸\中世纪UI\Backend\Mythostrike\src\Test\Main.java", "Java", 142, 10, 21, 173
"Total", "-", 1267, 80, 369, 1716